"","pitcher","hit","out","total","obp"
"1",425794,151,270,421,0.358669833729216
"2",425844,158,383,541,0.292051756007394
"3",434378,134,438,572,0.234265734265734
"4",445276,37,125,162,0.228395061728395
"5",445926,26,93,119,0.218487394957983
"6",446372,69,157,226,0.305309734513274
"7",448179,165,400,565,0.292035398230089
"8",450203,146,430,576,0.253472222222222
"9",453178,16,48,64,0.25
"10",453268,32,128,160,0.2
"11",453286,126,437,563,0.223801065719361
"12",455117,5,1,6,0.833333333333333
"13",455119,45,137,182,0.247252747252747
"14",456501,51,142,193,0.264248704663212
"15",456713,11,31,42,0.261904761904762
"16",458681,189,517,706,0.267705382436261
"17",471911,115,242,357,0.322128851540616
"18",472551,11,15,26,0.423076923076923
"19",472610,56,154,210,0.266666666666667
"20",476595,17,38,55,0.309090909090909
"21",477132,100,363,463,0.215982721382289
"22",488984,28,66,94,0.297872340425532
"23",489119,96,317,413,0.232445520581114
"24",489446,35,167,202,0.173267326732673
"25",493603,46,167,213,0.215962441314554
"26",500743,3,7,10,0.3
"27",500779,75,203,278,0.26978417266187
"28",500871,2,8,10,0.2
"29",502043,198,506,704,0.28125
"30",502083,9,15,24,0.375
"31",502085,52,178,230,0.226086956521739
"32",502171,163,416,579,0.281519861830743
"33",502179,14,10,24,0.583333333333333
"34",502202,15,57,72,0.208333333333333
"35",502624,90,232,322,0.279503105590062
"36",506433,134,376,510,0.262745098039216
"37",506702,1,3,4,0.25
"38",517008,2,7,9,0.222222222222222
"39",518397,55,125,180,0.305555555555556
"40",518489,42,159,201,0.208955223880597
"41",518516,25,42,67,0.373134328358209
"42",518585,52,189,241,0.215767634854772
"43",518617,36,148,184,0.195652173913043
"44",518876,143,480,623,0.229534510433387
"45",518886,42,190,232,0.181034482758621
"46",519008,4,5,9,0.444444444444444
"47",519043,46,145,191,0.240837696335079
"48",519151,54,180,234,0.230769230769231
"49",519242,87,287,374,0.232620320855615
"50",519293,44,158,202,0.217821782178218
"51",521230,4,13,17,0.235294117647059
"52",523260,27,110,137,0.197080291970803
"53",527048,150,377,527,0.284629981024668
"54",527054,68,194,262,0.259541984732824
"55",541640,77,154,231,0.333333333333333
"56",542194,3,1,4,0.75
"57",542208,4,4,8,0.5
"58",542585,61,155,216,0.282407407407407
"59",542881,141,375,516,0.273255813953488
"60",542888,36,150,186,0.193548387096774
"61",542914,19,56,75,0.253333333333333
"62",542947,34,75,109,0.311926605504587
"63",543037,153,563,716,0.213687150837989
"64",543056,45,143,188,0.23936170212766
"65",543063,1,2,3,0.333333333333333
"66",543101,102,262,364,0.28021978021978
"67",543135,115,375,490,0.23469387755102
"68",543243,156,512,668,0.233532934131737
"69",543272,54,142,196,0.275510204081633
"70",543281,8,3,11,0.727272727272727
"71",543294,138,384,522,0.264367816091954
"72",543339,2,9,11,0.181818181818182
"73",543351,18,84,102,0.176470588235294
"74",543475,176,494,670,0.262686567164179
"75",543507,34,128,162,0.209876543209877
"76",543510,2,3,5,0.4
"77",543518,59,191,250,0.236
"78",543521,69,156,225,0.306666666666667
"79",543543,2,4,6,0.333333333333333
"80",543548,7,24,31,0.225806451612903
"81",543594,7,9,16,0.4375
"82",543766,39,123,162,0.240740740740741
"83",543859,63,217,280,0.225
"84",543901,17,38,55,0.309090909090909
"85",544727,13,30,43,0.302325581395349
"86",545121,2,2,4,0.5
"87",547179,138,413,551,0.250453720508167
"88",547184,13,46,59,0.220338983050847
"89",547943,53,145,198,0.267676767676768
"90",547973,37,171,208,0.177884615384615
"91",548384,44,152,196,0.224489795918367
"92",548389,104,252,356,0.292134831460674
"93",552640,12,33,45,0.266666666666667
"94",554340,67,175,242,0.276859504132231
"95",554430,156,513,669,0.233183856502242
"96",570257,13,29,42,0.30952380952381
"97",570632,50,115,165,0.303030303030303
"98",570666,46,69,115,0.4
"99",570731,1,4,5,0.2
"100",571466,7,10,17,0.411764705882353
"101",571479,25,70,95,0.263157894736842
"102",571510,69,198,267,0.258426966292135
"103",571539,28,65,93,0.301075268817204
"104",571578,210,468,678,0.309734513274336
"105",571616,4,10,14,0.285714285714286
"106",571656,54,203,257,0.21011673151751
"107",571670,70,144,214,0.327102803738318
"108",571710,4,9,13,0.307692307692308
"109",571760,143,409,552,0.259057971014493
"110",571863,41,101,142,0.288732394366197
"111",571875,1,3,4,0.25
"112",571882,50,151,201,0.248756218905473
"113",571901,65,126,191,0.340314136125654
"114",571912,9,9,18,0.5
"115",571927,108,288,396,0.272727272727273
"116",571945,226,547,773,0.292367399741268
"117",571946,19,120,139,0.136690647482014
"118",571948,48,172,220,0.218181818181818
"119",572008,2,3,5,0.4
"120",572020,93,265,358,0.259776536312849
"121",572193,18,30,48,0.375
"122",572403,49,165,214,0.228971962616822
"123",572888,2,8,10,0.2
"124",572955,60,169,229,0.262008733624454
"125",572971,45,101,146,0.308219178082192
"126",573009,35,104,139,0.251798561151079
"127",573124,39,142,181,0.215469613259669
"128",573186,115,366,481,0.239085239085239
"129",573204,23,86,109,0.211009174311927
"130",579328,152,435,587,0.258943781942078
"131",592094,35,155,190,0.184210526315789
"132",592222,2,1,3,0.666666666666667
"133",592229,44,101,145,0.303448275862069
"134",592254,16,48,64,0.25
"135",592332,163,524,687,0.2372634643377
"136",592346,7,8,15,0.466666666666667
"137",592351,149,422,571,0.260945709281961
"138",592390,0,3,3,0
"139",592426,26,92,118,0.220338983050847
"140",592454,25,107,132,0.189393939393939
"141",592473,2,17,19,0.105263157894737
"142",592527,4,8,12,0.333333333333333
"143",592662,4,9,13,0.307692307692308
"144",592741,46,119,165,0.278787878787879
"145",592767,141,375,516,0.273255813953488
"146",592773,40,143,183,0.218579234972678
"147",592779,19,76,95,0.2
"148",592789,104,248,352,0.295454545454545
"149",592791,156,430,586,0.266211604095563
"150",592826,35,107,142,0.246478873239437
"151",592836,155,478,633,0.244865718799368
"152",592848,9,39,48,0.1875
"153",592866,178,399,577,0.308492201039861
"154",593334,83,307,390,0.212820512820513
"155",593423,2,4,6,0.333333333333333
"156",593576,41,187,228,0.179824561403509
"157",593619,13,48,61,0.213114754098361
"158",593643,6,4,10,0.6
"159",593833,6,22,28,0.214285714285714
"160",593958,121,407,528,0.229166666666667
"161",593974,36,140,176,0.204545454545455
"162",594577,34,68,102,0.333333333333333
"163",594580,47,165,212,0.221698113207547
"164",594798,19,88,107,0.177570093457944
"165",594835,55,133,188,0.292553191489362
"166",594902,96,252,348,0.275862068965517
"167",594943,30,74,104,0.288461538461538
"168",595345,47,155,202,0.232673267326733
"169",595411,6,18,24,0.25
"170",595897,3,7,10,0.3
"171",595928,17,54,71,0.23943661971831
"172",595978,5,10,15,0.333333333333333
"173",596001,90,233,323,0.278637770897833
"174",596057,10,35,45,0.222222222222222
"175",596082,5,1,6,0.833333333333333
"176",596112,27,146,173,0.15606936416185
"177",596133,155,348,503,0.308151093439364
"178",596271,32,73,105,0.304761904761905
"179",596295,164,369,533,0.307692307692308
"180",598264,25,58,83,0.301204819277108
"181",598286,40,110,150,0.266666666666667
"182",600917,37,163,200,0.185
"183",600921,53,129,182,0.291208791208791
"184",600986,0,8,8,0
"185",601713,110,408,518,0.212355212355212
"186",605130,60,177,237,0.253164556962025
"187",605135,176,555,731,0.240766073871409
"188",605151,13,20,33,0.393939393939394
"189",605154,31,109,140,0.221428571428571
"190",605155,6,23,29,0.206896551724138
"191",605177,45,139,184,0.244565217391304
"192",605182,121,369,490,0.246938775510204
"193",605200,98,225,323,0.303405572755418
"194",605218,31,88,119,0.260504201680672
"195",605242,48,148,196,0.244897959183673
"196",605280,50,166,216,0.231481481481481
"197",605288,121,308,429,0.282051282051282
"198",605347,65,157,222,0.292792792792793
"199",605397,90,265,355,0.253521126760563
"200",605400,178,535,713,0.249649368863955
"201",605441,3,4,7,0.428571428571429
"202",605446,9,12,21,0.428571428571429
"203",605447,48,166,214,0.224299065420561
"204",605463,23,50,73,0.315068493150685
"205",605483,115,504,619,0.18578352180937
"206",605488,4,44,48,0.0833333333333333
"207",605498,33,79,112,0.294642857142857
"208",605513,37,85,122,0.30327868852459
"209",605540,40,188,228,0.175438596491228
"210",605612,4,5,9,0.444444444444444
"211",606149,54,155,209,0.258373205741627
"212",606160,73,185,258,0.282945736434109
"213",606303,57,187,244,0.233606557377049
"214",606625,4,4,8,0.5
"215",606930,18,38,56,0.321428571428571
"216",606965,34,116,150,0.226666666666667
"217",607054,3,6,9,0.333333333333333
"218",607067,110,346,456,0.241228070175439
"219",607074,65,177,242,0.268595041322314
"220",607179,37,150,187,0.197860962566845
"221",607188,4,5,9,0.444444444444444
"222",607192,86,328,414,0.207729468599034
"223",607216,2,15,17,0.117647058823529
"224",607237,22,61,83,0.265060240963855
"225",607259,98,293,391,0.250639386189258
"226",607359,13,33,46,0.282608695652174
"227",607455,9,17,26,0.346153846153846
"228",607457,14,19,33,0.424242424242424
"229",607461,3,3,6,0.5
"230",607481,53,167,220,0.240909090909091
"231",607536,180,396,576,0.3125
"232",607625,140,400,540,0.259259259259259
"233",607644,13,69,82,0.158536585365854
"234",607732,12,21,33,0.363636363636364
"235",607755,45,123,168,0.267857142857143
"236",607968,27,46,73,0.36986301369863
"237",608032,62,175,237,0.261603375527426
"238",608328,18,29,47,0.382978723404255
"239",608331,70,212,282,0.24822695035461
"240",608334,6,26,32,0.1875
"241",608337,161,510,671,0.239940387481371
"242",608344,77,210,287,0.268292682926829
"243",608348,9,7,16,0.5625
"244",608371,30,166,196,0.153061224489796
"245",608379,108,367,475,0.227368421052632
"246",608566,19,53,72,0.263888888888889
"247",608638,34,108,142,0.23943661971831
"248",608648,1,6,7,0.142857142857143
"249",608665,51,177,228,0.223684210526316
"250",608678,49,145,194,0.252577319587629
"251",608717,66,222,288,0.229166666666667
"252",608718,64,189,253,0.25296442687747
"253",608723,39,101,140,0.278571428571429
"254",611093,5,20,25,0.2
"255",612434,51,184,235,0.217021276595745
"256",613534,16,49,65,0.246153846153846
"257",613564,5,6,11,0.454545454545455
"258",614179,52,119,171,0.304093567251462
"259",615698,111,270,381,0.291338582677165
"260",620454,2,0,2,1
"261",621016,62,173,235,0.263829787234043
"262",621051,35,150,185,0.189189189189189
"263",621057,22,50,72,0.305555555555556
"264",621074,39,105,144,0.270833333333333
"265",621076,66,170,236,0.279661016949153
"266",621107,158,492,650,0.243076923076923
"267",621112,117,281,398,0.293969849246231
"268",621139,3,17,20,0.15
"269",621199,6,10,16,0.375
"270",621237,30,111,141,0.212765957446809
"271",621244,173,528,701,0.24679029957204
"272",621249,24,62,86,0.27906976744186
"273",621294,16,48,64,0.25
"274",621295,30,80,110,0.272727272727273
"275",621345,56,177,233,0.240343347639485
"276",621363,42,167,209,0.200956937799043
"277",621366,25,102,127,0.196850393700787
"278",621368,23,45,68,0.338235294117647
"279",621381,66,240,306,0.215686274509804
"280",621383,54,160,214,0.252336448598131
"281",621389,102,192,294,0.346938775510204
"282",621433,1,1,2,0.5
"283",622065,49,146,195,0.251282051282051
"284",622072,98,266,364,0.269230769230769
"285",622075,42,123,165,0.254545454545455
"286",622088,3,16,19,0.157894736842105
"287",622098,50,150,200,0.25
"288",622103,11,26,37,0.297297297297297
"289",622110,3,6,9,0.333333333333333
"290",622250,43,145,188,0.228723404255319
"291",622251,16,55,71,0.225352112676056
"292",622259,16,48,64,0.25
"293",622491,160,560,720,0.222222222222222
"294",622503,19,35,54,0.351851851851852
"295",622554,48,140,188,0.25531914893617
"296",622569,3,6,9,0.333333333333333
"297",622608,7,21,28,0.25
"298",622663,104,241,345,0.301449275362319
"299",622766,8,41,49,0.163265306122449
"300",622772,25,91,116,0.21551724137931
"301",622780,21,78,99,0.212121212121212
"302",623149,45,168,213,0.211267605633803
"303",623167,133,277,410,0.324390243902439
"304",623211,53,155,208,0.254807692307692
"305",623352,32,160,192,0.166666666666667
"306",623381,5,8,13,0.384615384615385
"307",623433,29,95,124,0.233870967741935
"308",623437,59,182,241,0.244813278008299
"309",623451,13,31,44,0.295454545454545
"310",623465,38,168,206,0.184466019417476
"311",623474,33,80,113,0.292035398230089
"312",623507,1,3,4,0.25
"313",624133,129,335,464,0.27801724137931
"314",624522,20,80,100,0.2
"315",624647,27,88,115,0.234782608695652
"316",625643,49,181,230,0.21304347826087
"317",628317,94,294,388,0.242268041237113
"318",628452,51,159,210,0.242857142857143
"319",628708,47,109,156,0.301282051282051
"320",628711,106,314,420,0.252380952380952
"321",629498,1,1,2,0.5
"322",630023,85,219,304,0.279605263157895
"323",640444,9,26,35,0.257142857142857
"324",640448,66,182,248,0.266129032258065
"325",640451,44,166,210,0.20952380952381
"326",640454,6,7,13,0.461538461538462
"327",640455,103,311,414,0.248792270531401
"328",640462,54,158,212,0.254716981132075
"329",640470,52,174,226,0.230088495575221
"330",641149,10,12,22,0.454545454545455
"331",641154,176,546,722,0.243767313019391
"332",641302,44,121,165,0.266666666666667
"333",641329,33,118,151,0.218543046357616
"334",641360,58,185,243,0.238683127572016
"335",641401,29,77,106,0.273584905660377
"336",641420,6,9,15,0.4
"337",641427,8,20,28,0.285714285714286
"338",641447,7,7,14,0.5
"339",641482,59,178,237,0.248945147679325
"340",641525,0,3,3,0
"341",641540,160,445,605,0.264462809917355
"342",641585,138,373,511,0.270058708414873
"343",641627,63,161,224,0.28125
"344",641645,1,3,4,0.25
"345",641656,42,152,194,0.216494845360825
"346",641672,33,74,107,0.308411214953271
"347",641703,52,141,193,0.269430051813472
"348",641712,85,184,269,0.315985130111524
"349",641729,50,160,210,0.238095238095238
"350",641743,13,41,54,0.240740740740741
"351",641745,42,109,151,0.278145695364238
"352",641755,21,44,65,0.323076923076923
"353",641771,47,99,146,0.321917808219178
"354",641778,54,126,180,0.3
"355",641793,94,259,353,0.26628895184136
"356",641816,22,72,94,0.234042553191489
"357",641835,50,137,187,0.267379679144385
"358",641871,39,138,177,0.220338983050847
"359",641927,123,383,506,0.243083003952569
"360",641941,45,195,240,0.1875
"361",642048,41,125,166,0.246987951807229
"362",642100,46,143,189,0.243386243386243
"363",642121,5,15,20,0.25
"364",642133,1,3,4,0.25
"365",642207,25,169,194,0.128865979381443
"366",642216,37,90,127,0.291338582677165
"367",642231,14,40,54,0.259259259259259
"368",642232,96,248,344,0.27906976744186
"369",642239,24,51,75,0.32
"370",642397,45,162,207,0.217391304347826
"371",642528,14,46,60,0.233333333333333
"372",642545,87,210,297,0.292929292929293
"373",642546,35,89,124,0.282258064516129
"374",642547,131,470,601,0.217970049916805
"375",642578,3,8,11,0.272727272727273
"376",642585,30,176,206,0.145631067961165
"377",642701,10,30,40,0.25
"378",642758,16,24,40,0.4
"379",642770,17,52,69,0.246376811594203
"380",643256,25,53,78,0.320512820512821
"381",643338,12,35,47,0.25531914893617
"382",643361,26,63,89,0.292134831460674
"383",643377,58,181,239,0.242677824267782
"384",643396,4,11,15,0.266666666666667
"385",643410,47,180,227,0.20704845814978
"386",643493,44,123,167,0.263473053892216
"387",643511,65,199,264,0.246212121212121
"388",645261,176,503,679,0.25920471281296
"389",645444,4,6,10,0.4
"390",645801,5,5,10,0.5
"391",646241,9,18,27,0.333333333333333
"392",646242,13,17,30,0.433333333333333
"393",647315,11,38,49,0.224489795918367
"394",647336,36,89,125,0.288
"395",650489,3,4,7,0.428571428571429
"396",650496,15,31,46,0.326086956521739
"397",650556,43,195,238,0.180672268907563
"398",650633,87,279,366,0.237704918032787
"399",650644,109,342,451,0.241685144124169
"400",650671,8,26,34,0.235294117647059
"401",650893,49,158,207,0.236714975845411
"402",650895,7,20,27,0.259259259259259
"403",650907,5,3,8,0.625
"404",650911,88,261,349,0.25214899713467
"405",650960,24,84,108,0.222222222222222
"406",656061,52,163,215,0.241860465116279
"407",656222,39,113,152,0.256578947368421
"408",656232,86,214,300,0.286666666666667
"409",656234,92,235,327,0.281345565749235
"410",656257,26,101,127,0.204724409448819
"411",656266,6,19,25,0.24
"412",656271,64,167,231,0.277056277056277
"413",656288,121,359,480,0.252083333333333
"414",656290,18,54,72,0.25
"415",656302,159,478,637,0.249607535321821
"416",656322,5,16,21,0.238095238095238
"417",656353,64,141,205,0.31219512195122
"418",656382,23,64,87,0.264367816091954
"419",656412,48,184,232,0.206896551724138
"420",656427,158,377,535,0.295327102803738
"421",656457,16,40,56,0.285714285714286
"422",656464,41,179,220,0.186363636363636
"423",656529,50,133,183,0.273224043715847
"424",656546,29,144,173,0.167630057803468
"425",656557,104,288,392,0.26530612244898
"426",656578,52,168,220,0.236363636363636
"427",656605,187,541,728,0.256868131868132
"428",656629,115,358,473,0.243128964059197
"429",656638,41,174,215,0.190697674418605
"430",656641,1,17,18,0.0555555555555556
"431",656657,12,22,34,0.352941176470588
"432",656669,1,4,5,0.2
"433",656716,3,2,5,0.6
"434",656730,35,97,132,0.265151515151515
"435",656731,141,339,480,0.29375
"436",656756,177,525,702,0.252136752136752
"437",656786,19,36,55,0.345454545454545
"438",656793,2,15,17,0.117647058823529
"439",656794,8,40,48,0.166666666666667
"440",656814,23,46,69,0.333333333333333
"441",656818,19,28,47,0.404255319148936
"442",656820,9,13,22,0.409090909090909
"443",656849,124,289,413,0.300242130750605
"444",656876,36,120,156,0.230769230769231
"445",656887,4,22,26,0.153846153846154
"446",656924,0,3,3,0
"447",656945,53,209,262,0.202290076335878
"448",656970,29,61,90,0.322222222222222
"449",656981,17,37,54,0.314814814814815
"450",656986,6,26,32,0.1875
"451",657006,167,474,641,0.260530421216849
"452",657024,49,178,227,0.215859030837004
"453",657031,22,47,69,0.318840579710145
"454",657041,3,3,6,0.5
"455",657044,20,85,105,0.19047619047619
"456",657053,69,235,304,0.226973684210526
"457",657093,7,12,19,0.368421052631579
"458",657097,39,149,188,0.207446808510638
"459",657140,40,84,124,0.32258064516129
"460",657240,55,196,251,0.219123505976096
"461",657248,14,30,44,0.318181818181818
"462",657265,33,107,140,0.235714285714286
"463",657272,3,2,5,0.6
"464",657277,197,568,765,0.257516339869281
"465",657376,169,435,604,0.279801324503311
"466",657424,6,17,23,0.260869565217391
"467",657508,52,172,224,0.232142857142857
"468",657514,48,136,184,0.260869565217391
"469",657571,64,163,227,0.281938325991189
"470",657585,22,51,73,0.301369863013699
"471",657612,59,106,165,0.357575757575758
"472",657697,4,10,14,0.285714285714286
"473",657746,146,449,595,0.245378151260504
"474",657756,113,242,355,0.31830985915493
"475",658648,43,134,177,0.242937853107345
"476",659275,42,75,117,0.358974358974359
"477",660261,73,215,288,0.253472222222222
"478",660271,85,365,450,0.188888888888889
"479",660431,3,0,3,1
"480",660593,25,55,80,0.3125
"481",660634,1,3,4,0.25
"482",660730,0,10,10,0
"483",660761,46,88,134,0.343283582089552
"484",660787,15,53,68,0.220588235294118
"485",660813,52,172,224,0.232142857142857
"486",660825,15,48,63,0.238095238095238
"487",660853,50,173,223,0.224215246636771
"488",660896,14,48,62,0.225806451612903
"489",660906,17,46,63,0.26984126984127
"490",661309,59,145,204,0.28921568627451
"491",661383,11,42,53,0.207547169811321
"492",661395,45,169,214,0.210280373831776
"493",661403,68,205,273,0.249084249084249
"494",661440,36,91,127,0.283464566929134
"495",661527,43,114,157,0.273885350318471
"496",662253,40,129,169,0.236686390532544
"497",663158,15,79,94,0.159574468085106
"498",663321,3,9,12,0.25
"499",663362,39,118,157,0.248407643312102
"500",663372,45,119,164,0.274390243902439
"501",663385,15,33,48,0.3125
"502",663423,30,86,116,0.258620689655172
"503",663432,1,3,4,0.25
"504",663455,1,6,7,0.142857142857143
"505",663460,19,45,64,0.296875
"506",663462,22,78,100,0.22
"507",663465,16,36,52,0.307692307692308
"508",663474,12,47,59,0.203389830508475
"509",663485,20,61,81,0.246913580246914
"510",663542,12,23,35,0.342857142857143
"511",663546,38,76,114,0.333333333333333
"512",663556,90,308,398,0.226130653266332
"513",663558,35,119,154,0.227272727272727
"514",663559,94,221,315,0.298412698412698
"515",663562,43,78,121,0.355371900826446
"516",663567,91,227,318,0.286163522012579
"517",663574,4,9,13,0.307692307692308
"518",663623,118,329,447,0.263982102908277
"519",663629,9,12,21,0.428571428571429
"520",663630,4,2,6,0.666666666666667
"521",663658,27,91,118,0.228813559322034
"522",663687,58,167,225,0.257777777777778
"523",663704,20,64,84,0.238095238095238
"524",663738,45,131,176,0.255681818181818
"525",663752,10,22,32,0.3125
"526",663753,10,16,26,0.384615384615385
"527",663765,61,128,189,0.322751322751323
"528",663773,71,194,265,0.267924528301887
"529",663776,145,389,534,0.271535580524345
"530",663804,34,75,109,0.311926605504587
"531",663855,57,175,232,0.245689655172414
"532",663878,35,114,149,0.23489932885906
"533",663897,0,3,3,0
"534",663903,182,432,614,0.296416938110749
"535",663941,83,232,315,0.263492063492063
"536",663947,55,230,285,0.192982456140351
"537",663971,0,3,3,0
"538",663978,6,14,20,0.3
"539",663986,63,190,253,0.24901185770751
"540",663989,16,40,56,0.285714285714286
"541",663992,15,61,76,0.197368421052632
"542",664028,19,47,66,0.287878787878788
"543",664062,81,270,351,0.230769230769231
"544",664076,6,34,40,0.15
"545",664126,26,130,156,0.166666666666667
"546",664129,2,11,13,0.153846153846154
"547",664139,69,202,271,0.254612546125461
"548",664192,44,124,168,0.261904761904762
"549",664199,67,156,223,0.300448430493274
"550",664202,1,5,6,0.166666666666667
"551",664208,48,177,225,0.213333333333333
"552",664285,166,533,699,0.237482117310443
"553",664294,37,159,196,0.188775510204082
"554",664299,143,459,602,0.237541528239203
"555",664353,65,181,246,0.264227642276423
"556",664744,0,3,3,0
"557",664747,44,185,229,0.192139737991266
"558",664776,10,24,34,0.294117647058824
"559",664849,7,23,30,0.233333333333333
"560",664854,22,99,121,0.181818181818182
"561",664874,0,2,2,0
"562",664875,65,202,267,0.243445692883895
"563",664901,9,6,15,0.6
"564",664942,24,32,56,0.428571428571429
"565",664948,17,30,47,0.361702127659574
"566",665001,16,44,60,0.266666666666667
"567",665019,4,5,9,0.444444444444444
"568",665048,21,53,74,0.283783783783784
"569",665152,171,482,653,0.261868300153139
"570",665620,9,42,51,0.176470588235294
"571",665622,109,301,410,0.265853658536585
"572",665625,49,158,207,0.236714975845411
"573",665665,17,39,56,0.303571428571429
"574",665734,6,38,44,0.136363636363636
"575",665795,78,273,351,0.222222222222222
"576",665871,92,290,382,0.240837696335079
"577",665896,14,24,38,0.368421052631579
"578",666129,148,431,579,0.255613126079447
"579",666142,63,248,311,0.202572347266881
"580",666154,42,89,131,0.320610687022901
"581",666157,50,94,144,0.347222222222222
"582",666159,60,211,271,0.22140221402214
"583",666168,62,142,204,0.303921568627451
"584",666200,162,496,658,0.246200607902736
"585",666201,93,244,337,0.275964391691395
"586",666204,11,65,76,0.144736842105263
"587",666205,106,186,292,0.363013698630137
"588",666207,1,1,2,0.5
"589",666208,2,4,6,0.333333333333333
"590",666214,131,301,432,0.303240740740741
"591",666277,46,131,177,0.259887005649718
"592",666364,26,65,91,0.285714285714286
"593",666374,65,196,261,0.24904214559387
"594",666619,68,182,250,0.272
"595",666720,20,38,58,0.344827586206897
"596",666721,20,55,75,0.266666666666667
"597",666745,82,243,325,0.252307692307692
"598",666808,51,184,235,0.217021276595745
"599",666818,30,88,118,0.254237288135593
"600",666974,60,198,258,0.232558139534884
"601",667427,18,50,68,0.264705882352941
"602",667463,45,94,139,0.323741007194245
"603",667755,33,114,147,0.224489795918367
"604",668338,13,43,56,0.232142857142857
"605",668470,0,1,1,0
"606",668665,28,65,93,0.301075268817204
"607",668674,46,140,186,0.247311827956989
"608",668676,37,57,94,0.393617021276596
"609",668678,188,582,770,0.244155844155844
"610",668754,5,20,25,0.2
"611",668834,1,20,21,0.0476190476190476
"612",668868,69,176,245,0.281632653061224
"613",668873,13,13,26,0.5
"614",668881,111,320,431,0.25754060324826
"615",668909,66,229,295,0.223728813559322
"616",668933,148,390,538,0.275092936802974
"617",668941,28,93,121,0.231404958677686
"618",668942,6,6,12,0.5
"619",668970,31,94,125,0.248
"620",668984,16,33,49,0.326530612244898
"621",669022,125,346,471,0.265392781316348
"622",669060,58,210,268,0.216417910447761
"623",669084,18,56,74,0.243243243243243
"624",669093,12,29,41,0.292682926829268
"625",669105,11,16,27,0.407407407407407
"626",669111,1,12,13,0.0769230769230769
"627",669145,17,34,51,0.333333333333333
"628",669160,29,132,161,0.180124223602484
"629",669165,0,6,6,0
"630",669169,17,41,58,0.293103448275862
"631",669194,156,365,521,0.299424184261036
"632",669203,140,525,665,0.210526315789474
"633",669211,35,65,100,0.35
"634",669212,72,189,261,0.275862068965517
"635",669270,16,34,50,0.32
"636",669276,24,65,89,0.269662921348315
"637",669302,164,524,688,0.238372093023256
"638",669330,83,339,422,0.196682464454976
"639",669373,58,226,284,0.204225352112676
"640",669387,28,99,127,0.220472440944882
"641",669391,5,10,15,0.333333333333333
"642",669395,18,46,64,0.28125
"643",669424,41,108,149,0.275167785234899
"644",669432,16,50,66,0.242424242424242
"645",669438,67,153,220,0.304545454545455
"646",669456,124,348,472,0.26271186440678
"647",669459,59,156,215,0.274418604651163
"648",669461,59,157,216,0.273148148148148
"649",669467,75,169,244,0.307377049180328
"650",669618,11,27,38,0.289473684210526
"651",669674,49,117,166,0.295180722891566
"652",669684,50,128,178,0.280898876404494
"653",669711,21,54,75,0.28
"654",669713,82,245,327,0.250764525993884
"655",669721,7,34,41,0.170731707317073
"656",669724,8,15,23,0.347826086956522
"657",669796,47,145,192,0.244791666666667
"658",669854,44,131,175,0.251428571428571
"659",669912,12,30,42,0.285714285714286
"660",669923,177,515,692,0.255780346820809
"661",669947,100,230,330,0.303030303030303
"662",669952,15,34,49,0.306122448979592
"663",670032,4,6,10,0.4
"664",670036,4,27,31,0.129032258064516
"665",670042,11,8,19,0.578947368421053
"666",670046,35,92,127,0.275590551181102
"667",670059,55,151,206,0.266990291262136
"668",670097,12,16,28,0.428571428571429
"669",670102,22,104,126,0.174603174603175
"670",670124,29,51,80,0.3625
"671",670156,4,1,5,0.8
"672",670167,38,124,162,0.234567901234568
"673",670174,85,221,306,0.277777777777778
"674",670183,9,17,26,0.346153846153846
"675",670241,15,56,71,0.211267605633803
"676",670280,53,189,242,0.21900826446281
"677",670329,19,33,52,0.365384615384615
"678",670712,1,7,8,0.125
"679",670766,7,15,22,0.318181818181818
"680",670810,14,24,38,0.368421052631579
"681",670871,2,6,8,0.25
"682",670912,152,483,635,0.239370078740157
"683",670950,60,208,268,0.223880597014925
"684",670955,0,6,6,0
"685",670970,14,23,37,0.378378378378378
"686",670990,39,101,140,0.278571428571429
"687",671096,100,303,403,0.248138957816377
"688",671106,127,334,461,0.275488069414317
"689",671111,19,55,74,0.256756756756757
"690",671131,24,54,78,0.307692307692308
"691",671212,8,44,52,0.153846153846154
"692",671345,64,176,240,0.266666666666667
"693",671737,106,301,407,0.26044226044226
"694",672282,141,407,548,0.257299270072993
"695",672335,56,142,198,0.282828282828283
"696",672391,27,60,87,0.310344827586207
"697",672578,61,190,251,0.243027888446215
"698",672582,45,114,159,0.283018867924528
"699",672710,72,182,254,0.283464566929134
"700",672715,21,61,82,0.25609756097561
"701",672730,14,31,45,0.311111111111111
"702",672782,1,6,7,0.142857142857143
"703",672841,5,12,17,0.294117647058824
"704",672851,60,146,206,0.29126213592233
"705",672860,0,5,5,0
"706",673111,3,6,9,0.333333333333333
"707",673540,115,446,561,0.204991087344029
"708",673858,6,5,11,0.545454545454545
"709",674003,56,154,210,0.266666666666667
"710",674072,86,241,327,0.262996941896024
"711",674285,15,27,42,0.357142857142857
"712",674370,52,132,184,0.282608695652174
"713",674444,11,37,48,0.229166666666667
"714",674681,8,11,19,0.421052631578947
"715",675540,98,261,359,0.272980501392758
"716",675627,83,187,270,0.307407407407407
"717",675911,146,533,679,0.215022091310751
"718",675916,24,110,134,0.17910447761194
"719",675921,4,10,14,0.285714285714286
"720",675989,30,57,87,0.344827586206897
"721",676050,2,14,16,0.125
"722",676083,8,19,27,0.296296296296296
"723",676092,24,53,77,0.311688311688312
"724",676106,13,32,45,0.288888888888889
"725",676130,33,116,149,0.221476510067114
"726",676206,11,42,53,0.207547169811321
"727",676254,61,161,222,0.274774774774775
"728",676265,47,102,149,0.315436241610738
"729",676272,105,348,453,0.231788079470199
"730",676391,3,3,6,0.5
"731",676395,26,80,106,0.245283018867925
"732",676440,112,365,477,0.234800838574423
"733",676475,8,5,13,0.615384615384615
"734",676477,82,192,274,0.299270072992701
"735",676534,31,71,102,0.303921568627451
"736",676596,56,130,186,0.301075268817204
"737",676632,1,2,3,0.333333333333333
"738",676664,165,472,637,0.259026687598116
"739",676680,30,136,166,0.180722891566265
"740",676684,40,141,181,0.220994475138122
"741",676689,0,3,3,0
"742",676701,4,5,9,0.444444444444444
"743",676702,9,34,43,0.209302325581395
"744",676710,100,339,439,0.227790432801822
"745",676714,14,37,51,0.274509803921569
"746",676760,32,128,160,0.2
"747",676775,36,116,152,0.236842105263158
"748",676961,1,7,8,0.125
"749",676979,12,32,44,0.272727272727273
"750",677020,12,29,41,0.292682926829268
"751",677053,44,161,205,0.214634146341463
"752",677076,6,7,13,0.461538461538462
"753",677161,7,24,31,0.225806451612903
"754",677651,25,76,101,0.247524752475248
"755",677865,28,71,99,0.282828282828283
"756",677944,23,62,85,0.270588235294118
"757",677960,68,152,220,0.309090909090909
"758",678061,24,71,95,0.252631578947368
"759",678226,6,11,17,0.352941176470588
"760",678394,165,418,583,0.283018867924528
"761",678606,37,81,118,0.313559322033898
"762",679346,8,17,25,0.32
"763",679525,77,203,280,0.275
"764",679885,13,27,40,0.325
"765",680232,6,14,20,0.3
"766",680570,119,317,436,0.272935779816514
"767",680573,7,13,20,0.35
"768",680686,152,435,587,0.258943781942078
"769",680689,17,45,62,0.274193548387097
"770",680694,125,452,577,0.216637781629116
"771",680704,37,158,195,0.18974358974359
"772",680723,51,91,142,0.359154929577465
"773",680735,28,93,121,0.231404958677686
"774",680739,34,84,118,0.288135593220339
"775",680742,5,9,14,0.357142857142857
"776",680767,15,26,41,0.365853658536585
"777",680983,2,3,5,0.4
"778",681190,30,109,139,0.215827338129496
"779",681217,41,140,181,0.226519337016575
"780",681402,27,56,83,0.325301204819277
"781",681432,5,19,24,0.208333333333333
"782",681517,4,4,8,0.5
"783",681584,0,2,2,0
"784",681806,28,106,134,0.208955223880597
"785",681807,10,15,25,0.4
"786",681808,1,1,2,0.5
"787",681810,2,4,6,0.333333333333333
"788",681857,83,287,370,0.224324324324324
"789",681867,40,90,130,0.307692307692308
"790",681869,12,25,37,0.324324324324324
"791",681882,29,66,95,0.305263157894737
"792",681892,6,33,39,0.153846153846154
"793",681911,52,142,194,0.268041237113402
"794",681982,38,96,134,0.283582089552239
"795",681987,2,3,5,0.4
"796",682010,25,55,80,0.3125
"797",682051,19,37,56,0.339285714285714
"798",682052,14,33,47,0.297872340425532
"799",682120,29,70,99,0.292929292929293
"800",682171,5,39,44,0.113636363636364
"801",682175,32,65,97,0.329896907216495
"802",682227,104,298,402,0.258706467661692
"803",682243,124,367,491,0.252545824847251
"804",682842,16,85,101,0.158415841584158
"805",682847,99,227,326,0.303680981595092
"806",682967,10,25,35,0.285714285714286
"807",682989,5,7,12,0.416666666666667
"808",682990,58,133,191,0.303664921465969
"809",683155,12,28,40,0.3
"810",683175,18,62,80,0.225
"811",683232,14,57,71,0.197183098591549
"812",683769,41,115,156,0.262820512820513
"813",685107,2,7,9,0.222222222222222
"814",685314,7,22,29,0.241379310344828
"815",685410,34,98,132,0.257575757575758
"816",686218,46,169,215,0.213953488372093
"817",686294,30,63,93,0.32258064516129
"818",686539,11,27,38,0.289473684210526
"819",686610,149,382,531,0.28060263653484
"820",686613,147,418,565,0.260176991150442
"821",686651,16,28,44,0.363636363636364
"822",686654,11,45,56,0.196428571428571
"823",686730,18,36,54,0.333333333333333
"824",686747,28,92,120,0.233333333333333
"825",686752,27,122,149,0.181208053691275
"826",686753,40,111,151,0.264900662251656
"827",686826,14,61,75,0.186666666666667
"828",686839,39,107,146,0.267123287671233
"829",686842,5,8,13,0.384615384615385
"830",686972,6,6,12,0.5
"831",686973,66,188,254,0.259842519685039
"832",687145,14,18,32,0.4375
"833",687330,51,181,232,0.219827586206897
"834",687396,27,73,100,0.27
"835",687798,30,63,93,0.32258064516129
"836",687830,14,56,70,0.2
"837",687888,32,62,94,0.340425531914894
"838",687922,10,20,30,0.333333333333333
"839",688427,8,15,23,0.347826086956522
"840",689147,3,9,12,0.25
"841",689167,4,20,24,0.166666666666667
"842",689172,1,3,4,0.25
"843",689225,36,95,131,0.274809160305344
"844",689266,53,93,146,0.363013698630137
"845",689690,0,8,8,0
"846",690829,9,28,37,0.243243243243243
"847",690986,29,99,128,0.2265625
"848",691094,3,6,9,0.333333333333333
"849",691587,65,261,326,0.199386503067485
"850",693312,7,12,19,0.368421052631579
"851",693433,75,247,322,0.232919254658385
"852",693821,160,471,631,0.253565768621236
"853",694037,22,77,99,0.222222222222222
"854",694297,109,263,372,0.293010752688172
"855",694363,53,141,194,0.27319587628866
"856",694813,46,86,132,0.348484848484849
"857",695243,24,93,117,0.205128205128205
"858",696136,33,93,126,0.261904761904762
"859",696147,15,44,59,0.254237288135593
"860",700363,17,73,90,0.188888888888889
"861",701643,34,95,129,0.263565891472868
